NAME: Debug
TILE-SIZE: 32
BACKGROUND-FILL: ./assets/sprites/black-wall.png
BACKGROUND-LAYER[]:
:10000000000000000000000000000000
:01000000000000000000000000000000
:00100000000000000000000000000000
:00010000000000000000000000000000
:00001000000000000000000000000000
:00000100000000000000000000000000
:00000010000000000000000000000000
:00000000100000000000000000000000
:00000000010000000000000000000000
:00000000001000000000000000000000
:00000000000100000000000000000000