NAME: Debug
TILE-SIZE: 32

BACKGROUND-FILL: ./assets/sprites/missing.png
// BACKGROUND-FILL: ./assets/sprites/black-wall.png

BACKGROUND-LAYER[]:
:0000000000000010000000000000000
:0110001001100010000000000000000
:1000101010000010000000111000000
:1100101011000010000001100000000
:0010101000100010000001111000000
:1100111011000010000000111000000
:0000000000000000000000101000000
:0000000000000000000000000000000
:0000000000000000000000000000000
:0000000000000000000000000000000
:1111111111100010001111111111111
:1000000000000000000000000000001
:1000000000000000000000000000001
:1000000000000000000000000000001
:1000000011111111110000000000001
:1000000000000000000000000000001
:1000000000000000000000000000001
:1100000000000000000011100000001
:1110000000000000000000000000001
:1111000000000000000000011100001
:1111100000000000000000000000001
:1111111111111111111111111111111