NAME: Debug
TILE-SIZE: 32

BACKGROUND-FILL: ./assets/sprites/black-wall.png

BACKGROUND-LAYER[]:
:0000000000000000000000000000000
:0110001001100000000000000000000
:1000101010000000000000111000000
:1100101011000000000001100000000
:0010101000100000000001111000000
:1100111011000000000000111000000
:0000000000000000000000101000000
:0000000000000000000000000000000
:0000000000000000000000000000000
:0000000000000000000000000000000
:0000000000000000000000000000000